############################
#     #cc    m     cc#     #
#     #c            c#     #
#                          #
#         #      #         #
###       #  cc  #       ###
#11       #  cc  #       22#
#11       #  cc  #       22#
###       #  cc  #       ###
#         #      #         #
#                          #
#     #c            c#     #
#     #cc         mcc#     #
############################