############################
#     #cc    ###   cc#     #
#     #c       ccc  c#     #
#                          #
#       # #      #         #
###     # #  cc  #       ###
#11     # #  cc  #       22#
#11     # #  cc  #       22#
###     # #  cc  #       ###
#       # #      #         #
#                          #
#     #c            c#     #
#     #cc          cc#     #
############################